1
5
15,2
5,40
25
52
0 0 0 0 0 0 0 0 0 0 0 0 0 0 0 0 0 0 0 0 0 0 0 0 0 0 0 0 0 0 0 0 0 0 0 0 0 0 0 0 0 0 0 0 0 0 0 0 0 0 0 0
0 0 0 0 0 0 0 0 0 0 0 0 0 0 0 0 0 0 0 0 0 0 0 0 0 0 0 0 0 0 0 0 0 0 0 0 0 0 0 0 0 0 0 0 0 0 0 0 0 0 0 0
0 0 0 0 0 0 0 0 0 0 0 0 0 0 0 0 0 0 0 0 0 0 0 0 0 0 0 0 0 0 0 0 0 0 0 0 0 0 0 0 0 0 0 0 0 0 0 0 0 0 0 0
0 0 0 0 0 0 0 0 0 0 0 0 0 0 0 0 0 0 0 0 0 0 0 0 0 0 0 0 0 0 0 0 0 0 0 0 0 0 0 0 0 0 0 0 0 0 0 0 0 0 0 0
0 0 0 0 0 0 0 0 0 0 0 0 0 0 0 0 0 0 0 0 0 0 0 0 0 0 0 0 0 0 0 0 0 0 0 0 0 0 0 0 0 0 0 0 0 0 0 0 0 0 0 0
0 0 0 0 0 0 0 0 0 0 0 0 0 0 0 0 0 0 0 0 0 0 0 0 0 0 0 0 0 0 0 0 0 0 0 0 0 0 0 0 98 0 0 0 0 0 0 0 0 0 0 0
0 0 0 0 0 0 0 0 0 0 0 0 0 0 0 0 0 0 0 0 0 0 0 0 0 0 0 0 0 0 0 0 0 0 0 0 0 0 0 1 10 10 0 10 2 0 0 0 0 0 0 0
0 0 0 0 0 0 0 0 0 0 0 0 0 0 0 0 0 0 0 0 0 0 0 0 0 0 0 0 0 0 0 0 0 0 0 0 0 0 0 0 11 11 11 11 0 0 0 0 0 0 0 0
0 0 0 0 0 0 0 0 0 0 0 0 0 0 0 0 0 0 0 0 0 0 0 0 0 0 0 0 0 0 0 0 0 0 0 0 0 0 0 0 11 0 11 11 0 5 0 0 0 0 0 3
0 0 0 0 0 0 0 0 0 0 0 0 0 0 0 0 0 0 0 0 5 0 0 0 0 0 0 0 0 0 0 0 0 0 0 0 0 0 0 0 11 11 11 12 10 10 10 7 8 6 10 10
0 0 0 0 0 0 0 0 0 0 0 1 14 16 0 0 0 1 10 10 10 10 2 0 0 0 0 3 0 0 0 4 0 0 0 0 0 5 0 0 11 11 11 11 11 11 11 8 8 8 11 11
0 0 0 0 0 0 0 0 0 0 0 0 0 0 0 0 0 0 0 11 11 11 0 0 0 1 10 10 10 10 10 10 10 10 7 8 6 10 10 10 13 11 11 11 11 11 11 11 8 8 11 0
0 0 0 0 0 0 0 0 0 0 0 0 0 0 0 0 0 0 11 11 11 11 0 0 0 0 11 0 11 11 11 11 11 11 8 8 8 11 11 11 11 11 11 11 11 11 11 8 8 8 11 11
0 0 0 0 0 0 0 1 14 0 15 2 0 0 0 0 0 0 11 11 11 0 0 0 0 0 11 11 11 11 11 0 11 11 8 8 8 11 11 0 11 11 11 8 8 8 0 8 8 8 11 11
0 0 0 0 0 0 0 0 0 0 0 0 0 0 0 0 0 0 0 11 11 11 0 0 0 0 11 11 11 11 11 11 11 11 8 8 8 11 11 11 11 11 11 8 8 8 8 8 8 11 11 11
0 0 99 0 0 0 3 0 0 0 0 0 0 0 0 0 4 0 11 11 11 11 0 0 0 0 11 11 11 11 11 11 11 11 8 8 8 11 11 11 11 11 11 11 11 0 11 8 8 8 11 11
10 10 10 10 10 10 10 10 10 10 10 10 10 10 10 10 10 10 13 11 11 11 0 0 0 0 11 11 11 8 8 8 8 8 8 8 8 11 11 11 11 11 11 11 11 11 11 8 8 8 11 11
11 0 11 11 11 11 11 11 11 11 11 0 11 11 11 11 11 11 11 0 11 11 0 0 0 0 11 11 11 8 8 8 8 8 0 8 8 11 11 11 0 11 11 11 11 11 11 11 8 8 0 11
11 11 11 11 11 11 11 11 11 11 11 11 11 11 11 11 11 11 11 11 11 11 0 0 0 0 11 0 11 8 8 8 8 8 8 8 8 11 11 11 11 11 11 11 11 11 11 8 8 8 11 11
11 11 11 11 11 11 0 11 11 11 11 11 11 11 11 0 11 11 11 11 11 11 0 0 0 0 11 11 11 8 8 8 11 11 11 11 11 11 11 11 11 11 11 11 11 11 11 8 8 8 11 11
11 11 11 11 11 11 11 11 11 11 11 0 11 11 11 11 11 11 11 11 11 11 0 0 0 0 11 11 11 8 0 8 8 8 8 8 8 8 8 8 8 8 8 8 8 8 8 8 8 11 11 11
11 11 11 11 11 11 11 11 11 11 11 11 11 11 11 11 11 11 11 11 11 11 0 0 0 0 11 11 11 8 8 8 8 8 8 8 8 8 8 8 8 8 8 8 8 8 0 8 8 8 11 11
11 11 0 11 11 11 11 11 11 11 11 11 11 11 11 11 11 11 11 11 11 11 0 0 0 0 11 11 11 8 8 8 8 8 8 8 8 8 8 8 8 8 8 8 8 8 8 8 8 8 11 11
11 11 11 11 11 11 11 11 0 11 11 11 11 11 11 11 11 0 11 11 11 11 0 0 0 0 11 11 11 11 11 11 11 11 11 11 11 11 11 11 11 11 11 11 11 11 11 11 11 11 11 11
11 11 11 11 11 11 11 11 11 11 11 11 11 11 11 11 11 11 11 11 11 11 0 0 0 0 11 11 11 11 11 11 11 0 11 11 11 11 11 11 0 11 11 11 11 11 11 11 0 11 11 11
810,570-2610,870
0_570,930-1_810,690-0_1770,630-0_1950,1350-0_2310,1350-0_2670,1350-1_2850,750-1_2970,930-1_2850,1110-1_1830,990
