2
6
16,2
3,48
20
50
0 0 0 0 0 0 0 0 0 0 0 0 0 0 0 0 0 0 0 0 0 0 0 0 0 0 0 0 0 0 0 0 0 0 0 0 0 0 0 0 0 0 0 0 0 0 0 0 0 0
0 0 0 0 0 0 0 0 0 0 0 0 0 0 0 0 0 0 0 0 0 0 0 0 0 0 0 0 0 0 0 0 0 0 0 0 0 0 0 0 0 0 0 0 0 0 0 0 0 0
0 0 0 0 0 0 0 0 0 0 0 0 0 0 0 0 0 0 0 0 0 0 0 0 0 0 0 0 0 0 0 0 0 0 0 0 0 0 0 0 0 0 0 0 0 0 0 0 0 0
0 0 0 0 0 0 0 0 0 0 0 0 0 0 0 0 0 0 1 10 10 2 0 1 10 10 2 0 0 0 0 0 0 0 0 0 0 0 0 0 1 14 0 15 2 0 0 0 98 0
0 0 0 0 0 0 0 0 0 0 0 0 0 0 0 0 0 0 0 0 11 0 0 0 11 0 0 0 0 0 0 0 0 0 0 0 0 0 0 0 0 0 0 0 0 0 1 14 16 0
0 1 14 0 16 16 15 2 0 1 14 16 16 16 15 2 0 1 14 19 17 0 0 0 17 18 15 2 0 1 16 2 0 1 16 2 0 1 16 2 0 0 0 0 0 0 0 0 0 0
0 0 0 0 0 0 0 0 0 0 0 0 0 0 0 0 0 0 0 0 0 0 0 0 0 0 0 0 0 0 0 0 0 0 0 0 0 0 0 0 0 0 0 0 0 0 0 0 0 0
0 0 0 0 0 0 0 0 0 0 0 0 0 0 0 0 0 0 0 0 0 0 0 0 0 0 0 0 0 0 0 0 0 0 0 0 0 0 0 0 0 0 0 0 0 0 1 16 2 0
15 2 0 0 0 0 0 0 0 0 0 0 0 0 0 0 0 0 0 0 0 0 0 0 0 0 0 0 0 0 0 0 0 0 0 0 0 0 0 0 0 0 0 0 0 0 0 0 0 0
0 0 0 0 0 0 0 0 0 0 0 0 0 0 0 0 0 0 0 0 0 0 0 0 0 0 0 0 0 0 0 0 0 0 0 0 0 0 0 0 0 0 0 0 0 0 0 0 0 0
0 0 0 0 0 0 0 0 0 0 0 0 0 0 0 0 0 0 0 0 0 0 0 0 0 0 0 0 0 0 0 0 0 0 0 0 0 0 0 0 0 0 0 0 1 14 16 15 2 0
0 1 14 0 16 16 15 2 0 1 14 16 0 16 15 2 0 0 0 0 0 0 0 0 0 0 0 0 0 0 0 0 0 0 0 0 0 0 0 0 0 0 0 0 0 0 0 0 0 0
0 0 0 0 0 0 0 0 0 0 0 0 0 0 0 0 0 0 0 0 0 0 0 0 0 0 0 0 0 0 0 0 0 0 0 0 0 0 0 0 0 0 0 0 0 0 0 0 0 0
0 0 0 0 0 0 0 0 0 0 0 0 0 0 0 0 0 0 0 0 0 0 0 0 0 0 0 0 0 0 0 0 0 0 0 1 10 10 2 0 1 10 10 2 0 0 0 0 0 0
0 0 0 0 0 0 0 0 0 0 0 0 0 0 0 0 0 1 10 10 10 0 10 2 0 0 0 0 0 0 0 0 0 0 1 10 13 11 0 0 0 11 12 10 2 0 0 0 0 0
0 0 0 0 0 0 0 0 0 0 0 0 0 0 0 0 0 0 0 11 11 11 11 0 0 0 0 0 0 0 0 0 0 1 10 13 0 11 0 0 0 0 11 12 10 2 0 0 0 0
0 0 99 0 0 3 0 0 0 0 5 0 0 0 0 0 0 0 11 11 11 11 11 0 0 0 0 0 0 0 0 0 1 10 13 11 11 11 0 0 0 11 11 11 12 10 2 0 0 0
10 10 10 10 10 0 10 10 10 10 10 10 10 10 10 10 10 10 13 0 11 11 0 0 0 1 10 10 10 10 10 0 10 13 11 11 11 11 0 0 0 11 0 11 11 12 10 10 10 0
11 11 11 11 11 11 11 0 11 11 11 11 11 11 11 0 11 11 11 11 11 11 11 0 0 0 11 0 11 11 11 11 11 11 0 11 11 11 0 0 0 11 11 11 11 11 0 11 11 11
11 11 0 11 11 11 11 11 11 11 11 0 11 11 11 11 11 11 11 11 0 11 11 0 0 0 11 11 11 0 11 11 11 11 11 11 11 11 0 0 0 11 11 11 0 11 11 11 11 11
270,630-1350,390
1_2790,570-0_1770,990-0_1230,810-0_750,990-0_750,630-1_750,270-1_2550,150
