0
0
248,2
1,17
250
18
11 11 11 11 11 0 0 0 0 0 0 0 0 0 0 0 0 0
11 11 11 11 11 0 0 0 0 0 0 0 0 0 0 0 0 98
11 11 11 11 11 0 0 0 0 0 0 0 1 10 10 10 10 10
11 11 11 11 11 0 0 0 0 0 0 0 0 11 11 11 11 11
11 11 11 11 11 0 0 0 0 0 0 1 14 13 11 11 11 11
11 11 11 11 11 0 0 0 0 0 0 0 0 11 11 11 11 11
11 11 11 11 11 0 0 0 0 0 0 0 0 11 11 11 11 11
11 11 11 11 11 0 0 0 1 14 15 2 0 11 11 11 11 11
11 11 11 11 11 0 0 0 0 0 0 0 0 11 11 11 11 11
11 11 11 11 11 0 0 0 0 0 0 0 0 11 11 11 11 11
11 11 11 11 12 15 2 0 0 0 0 0 0 11 11 11 11 11
11 11 11 11 11 0 0 0 0 0 0 0 0 11 11 11 11 11
11 11 11 11 11 0 0 0 0 0 0 0 0 11 11 11 11 11
11 11 11 11 11 0 1 16 2 0 0 0 0 11 11 11 11 11
11 11 11 11 11 0 0 0 0 0 0 0 0 11 11 11 11 11
11 11 11 11 11 0 0 0 0 0 0 0 0 11 11 11 11 11
11 11 11 11 11 0 0 0 0 1 16 2 0 11 11 11 11 11
11 11 11 11 11 0 0 0 0 0 0 0 0 11 11 11 11 11
11 11 11 11 11 0 0 0 0 0 0 0 0 11 11 11 11 11
11 11 11 11 11 0 1 16 2 0 0 1 14 13 11 11 11 11
11 11 11 11 11 0 0 0 0 0 0 0 0 11 11 11 11 11
11 11 11 11 12 15 2 0 0 0 0 0 0 11 11 11 11 11
11 11 11 11 11 0 0 0 1 16 2 0 0 11 11 11 11 11
11 11 11 11 11 0 0 0 0 0 0 0 0 11 11 11 11 11
11 11 11 11 12 15 2 0 0 0 0 1 14 13 11 11 11 11
11 11 11 11 11 0 0 0 0 0 0 0 0 11 11 11 11 11
11 11 11 11 11 0 0 0 0 0 0 0 0 11 11 11 11 11
11 11 11 11 12 16 15 2 0 0 0 1 14 13 11 11 11 11
11 11 11 11 11 0 0 0 0 0 0 0 0 11 11 11 11 11
11 11 11 11 11 0 0 0 0 0 0 0 0 11 11 11 11 11
11 11 11 11 11 0 1 16 2 1 16 2 0 11 11 11 11 11
11 11 11 11 11 0 0 0 0 0 0 0 0 11 11 11 11 11
11 11 11 11 11 0 0 0 0 0 0 0 0 11 11 11 11 11
11 11 11 11 12 16 15 2 0 0 0 1 14 13 11 11 11 11
11 11 11 11 11 0 0 0 0 0 0 0 0 11 11 11 11 11
11 11 11 11 11 0 0 0 0 0 0 0 0 11 11 11 11 11
11 11 11 11 11 0 1 16 2 1 16 2 0 11 11 11 11 11
11 11 11 11 11 0 0 0 0 0 0 0 0 11 11 11 11 11
11 11 11 11 11 0 0 0 0 0 0 0 0 11 11 11 11 11
11 11 11 11 11 0 1 14 16 16 15 2 0 11 11 11 11 11
11 11 11 11 11 0 0 0 0 0 0 0 0 11 11 11 11 11
11 11 11 11 11 0 0 0 0 0 0 0 0 11 11 11 11 11
11 11 11 11 12 15 2 0 0 0 0 0 0 11 11 11 11 11
11 11 11 11 11 0 0 0 0 0 0 0 0 11 11 11 11 11
11 11 11 11 11 0 0 0 0 0 0 0 0 11 11 11 11 11
11 11 11 11 11 0 1 16 2 0 0 0 0 11 11 11 11 11
11 11 11 11 11 0 0 0 0 0 0 0 0 11 11 11 11 11
11 11 11 11 11 0 0 0 0 0 1 14 16 13 11 11 11 11
11 11 11 11 11 0 0 0 0 0 0 0 0 11 11 11 11 11
11 11 11 11 11 0 0 0 0 0 0 0 0 11 11 11 11 11
11 11 11 11 11 0 0 0 1 16 2 0 0 11 11 11 11 11
11 11 11 11 11 0 0 0 0 0 0 0 0 11 11 11 11 11
11 11 11 11 11 0 0 0 0 0 0 0 0 11 11 11 11 11
11 11 11 11 11 1 14 16 16 15 2 0 0 11 11 11 11 11
11 11 11 11 11 0 0 0 0 0 0 0 0 11 11 11 11 11
11 11 11 11 11 0 0 0 0 0 0 1 14 13 11 11 11 11
11 11 11 11 11 0 0 0 0 0 0 0 0 11 11 11 11 11
11 11 11 11 11 0 0 0 0 0 0 0 0 11 11 11 11 11
11 11 11 11 11 0 0 0 0 1 16 2 0 11 11 11 11 11
11 11 11 11 11 0 0 0 0 0 0 0 0 11 11 11 11 11
11 11 11 11 11 0 1 16 2 0 0 0 0 11 11 11 11 11
11 11 11 11 11 0 0 0 0 0 0 0 0 11 11 11 11 11
11 11 11 11 11 0 0 0 0 1 16 2 0 11 11 11 11 11
11 11 11 11 11 0 0 0 0 0 0 0 0 11 11 11 11 11
11 11 11 11 11 0 1 16 2 0 0 0 0 11 11 11 11 11
11 11 11 11 11 0 0 0 0 0 0 0 0 11 11 11 11 11
11 11 11 11 11 0 0 0 0 0 0 0 0 11 11 11 11 11
11 11 11 11 12 15 2 0 0 0 0 0 0 11 11 11 11 11
11 11 11 11 11 0 0 0 0 0 0 0 0 11 11 11 11 11
11 11 11 11 11 0 0 0 0 0 0 0 0 11 11 11 11 11
11 11 11 11 11 0 1 14 16 16 15 2 0 11 11 11 11 11
11 11 11 11 11 0 0 0 0 0 0 0 0 11 11 11 11 11
11 11 11 11 11 0 0 0 0 0 0 0 0 11 11 11 11 11
11 11 11 11 12 15 2 0 0 0 0 1 14 13 11 11 11 11
11 11 11 11 11 0 0 0 0 0 0 0 0 11 11 11 11 11
11 11 11 11 11 0 0 0 0 0 0 0 0 11 11 11 11 11
11 11 11 11 12 15 2 0 0 0 1 14 16 13 11 11 11 11
11 11 11 11 11 0 0 0 0 0 0 0 0 11 11 11 11 11
11 11 11 11 11 0 0 0 0 0 0 0 0 11 11 11 11 11
11 11 11 11 11 0 0 1 16 2 0 0 0 11 11 11 11 11
11 11 11 11 11 0 0 0 0 0 0 0 0 11 11 11 11 11
11 11 11 11 11 0 0 0 0 0 0 0 0 11 11 11 11 11
11 11 11 11 11 0 0 0 0 1 16 2 0 11 11 11 11 11
11 11 11 11 11 0 0 0 0 0 0 0 0 11 11 11 11 11
11 11 11 11 11 0 0 0 0 0 0 0 0 11 11 11 11 11
11 11 11 11 12 16 16 15 2 0 0 0 0 11 11 11 11 11
11 11 11 11 11 0 0 0 0 0 0 0 0 11 11 11 11 11
11 11 11 11 11 0 0 0 0 0 0 0 0 11 11 11 11 11
11 11 11 11 11 0 0 0 0 1 14 16 16 13 11 11 11 11
11 11 11 11 11 0 0 0 0 0 0 0 0 11 11 11 11 11
11 11 11 11 11 0 0 0 0 0 0 0 0 11 11 11 11 11
11 11 11 11 12 16 16 15 2 0 0 0 0 11 11 11 11 11
11 11 11 11 11 0 0 0 0 0 0 0 0 11 11 11 11 11
11 11 11 11 11 0 0 0 0 0 0 0 0 11 11 11 11 11
11 11 11 11 11 0 0 1 16 2 0 0 0 11 11 11 11 11
11 11 11 11 11 0 0 0 0 0 0 0 0 11 11 11 11 11
11 11 11 11 11 0 0 0 0 0 1 16 2 11 11 11 11 11
11 11 11 11 11 0 0 0 0 0 0 0 0 11 11 11 11 11
11 11 11 11 11 0 0 0 0 0 0 0 0 11 11 11 11 11
11 11 11 11 11 0 0 0 1 16 2 0 0 11 11 11 11 11
11 11 11 11 11 0 0 0 0 0 0 0 0 11 11 11 11 11
11 11 11 11 11 0 0 0 0 0 0 0 0 11 11 11 11 11
11 11 11 11 11 1 16 2 0 0 0 0 0 11 11 11 11 11
11 11 11 11 11 0 0 0 0 0 0 0 0 11 11 11 11 11
11 11 11 11 11 0 0 0 0 0 0 0 0 11 11 11 11 11
11 11 11 11 11 0 0 0 1 16 2 0 0 11 11 11 11 11
11 11 11 11 11 0 0 0 0 0 0 0 0 11 11 11 11 11
11 11 11 11 11 0 0 0 0 0 0 0 0 11 11 11 11 11
11 11 11 11 11 0 0 0 0 0 1 14 16 13 11 11 11 11
11 11 11 11 11 0 0 0 0 0 0 0 0 11 11 11 11 11
11 11 11 11 11 0 0 0 0 0 0 0 0 11 11 11 11 11
11 11 11 11 11 0 0 1 14 15 2 0 0 11 11 11 11 11
11 11 11 11 11 0 0 0 0 0 0 0 0 11 11 11 11 11
11 11 11 11 11 0 0 0 0 0 0 0 0 11 11 11 11 11
11 11 11 11 11 1 16 2 0 0 0 1 14 13 11 11 11 11
11 11 11 11 11 0 0 0 0 0 0 0 0 11 11 11 11 11
11 11 11 11 11 0 0 0 0 0 0 0 0 11 11 11 11 11
11 11 11 11 12 15 2 0 0 0 0 1 14 13 11 11 11 11
11 11 11 11 11 0 0 0 0 0 0 0 0 11 11 11 11 11
11 11 11 11 11 0 0 0 0 0 0 0 0 11 11 11 11 11
11 11 11 11 12 16 15 2 0 0 0 1 14 13 11 11 11 11
11 11 11 11 11 0 0 0 0 0 0 0 0 11 11 11 11 11
11 11 11 11 11 0 0 0 0 0 0 0 0 11 11 11 11 11
11 11 11 11 11 0 0 1 14 15 2 0 0 11 11 11 11 11
11 11 11 11 11 0 0 0 0 0 0 0 0 11 11 11 11 11
11 11 11 11 11 0 0 0 0 0 0 0 0 11 11 11 11 11
11 11 11 11 11 0 1 14 16 16 15 2 0 11 11 11 11 11
11 11 11 11 11 0 0 0 0 0 0 0 0 11 11 11 11 11
11 11 11 11 11 0 0 0 0 0 0 0 0 11 11 11 11 11
11 11 11 11 11 1 16 2 0 0 1 16 2 11 11 11 11 11
11 11 11 11 11 0 0 0 0 0 0 0 0 11 11 11 11 11
11 11 11 11 11 0 0 0 0 0 0 0 0 11 11 11 11 11
11 11 11 11 11 0 0 0 1 16 2 0 0 11 11 11 11 11
11 11 11 11 11 0 0 0 0 0 0 0 0 11 11 11 11 11
11 11 11 11 11 0 1 16 2 0 0 0 0 11 11 11 11 11
11 11 11 11 11 0 0 0 0 0 0 0 0 11 11 11 11 11
11 11 11 11 11 0 0 0 1 16 2 0 0 11 11 11 11 11
11 11 11 11 11 0 0 0 0 0 0 0 0 11 11 11 11 11
11 11 11 11 11 0 0 0 0 0 0 1 14 13 11 11 11 11
11 11 11 11 11 0 0 0 0 0 0 0 0 11 11 11 11 11
11 11 11 11 11 0 0 0 1 16 2 0 0 11 11 11 11 11
11 11 11 11 11 0 0 0 0 0 0 0 0 11 11 11 11 11
11 11 11 11 12 16 15 2 0 0 0 0 0 11 11 11 11 11
11 11 11 11 11 0 0 0 0 0 0 0 0 11 11 11 11 11
11 11 11 11 11 0 0 0 0 0 0 0 0 11 11 11 11 11
11 11 11 11 12 16 16 15 2 0 0 0 0 11 11 11 11 11
11 11 11 11 11 0 0 0 0 0 0 0 0 11 11 11 11 11
11 11 11 11 11 0 0 0 0 0 0 0 0 11 11 11 11 11
11 11 11 11 11 0 0 1 16 16 2 0 0 11 11 11 11 11
11 11 11 11 11 0 0 0 0 0 0 0 0 11 11 11 11 11
11 11 11 11 11 0 0 0 0 0 0 0 0 11 11 11 11 11
11 11 11 11 11 0 16 2 0 0 1 16 2 11 11 11 11 11
11 11 11 11 11 0 0 0 0 0 0 0 0 11 11 11 11 11
11 11 11 11 11 0 0 0 0 0 0 0 0 11 11 11 11 11
11 11 11 11 12 15 2 0 0 0 0 1 14 13 11 11 11 11
11 11 11 11 11 0 0 0 0 0 0 0 0 11 11 11 11 11
11 11 11 11 11 0 0 0 0 0 0 0 0 11 11 11 11 11
11 11 11 11 11 0 16 2 0 0 1 16 2 11 11 11 11 11
11 11 11 11 11 0 0 0 0 0 0 0 0 11 11 11 11 11
11 11 11 11 11 0 0 0 0 0 0 0 0 11 11 11 11 11
11 11 11 11 11 0 0 0 1 16 2 0 0 11 11 11 11 11
11 11 11 11 11 0 0 0 0 0 0 0 0 11 11 11 11 11
11 11 11 11 11 1 16 2 0 0 0 0 0 11 11 11 11 11
11 11 11 11 11 0 0 0 0 0 0 0 0 11 11 11 11 11
11 11 11 11 11 0 0 0 1 16 2 0 0 11 11 11 11 11
11 11 11 11 11 0 0 0 0 0 0 0 0 11 11 11 11 11
11 11 11 11 11 0 0 0 0 0 0 1 14 13 11 11 11 11
11 11 11 11 11 0 0 0 0 0 0 0 0 11 11 11 11 11
11 11 11 11 11 0 0 0 0 0 0 0 0 11 11 11 11 11
11 11 11 11 11 0 0 0 1 16 2 0 0 11 11 11 11 11
11 11 11 11 11 0 0 0 0 0 0 0 0 11 11 11 11 11
11 11 11 11 11 0 0 0 0 0 0 0 0 11 11 11 11 11
11 11 11 11 12 16 16 15 2 0 0 0 0 11 11 11 11 11
11 11 11 11 11 0 0 0 0 0 0 0 0 11 11 11 11 11
11 11 11 11 11 0 0 0 0 0 0 0 0 11 11 11 11 11
11 11 11 11 11 0 0 0 1 14 15 2 0 11 11 11 11 11
11 11 11 11 11 0 0 0 0 0 0 0 0 11 11 11 11 11
11 11 11 11 11 0 0 0 0 0 0 0 0 11 11 11 11 11
11 11 11 11 11 1 14 15 2 0 0 1 14 13 11 11 11 11
11 11 11 11 11 0 0 0 0 0 0 0 0 11 11 11 11 11
11 11 11 11 11 0 0 0 0 0 0 0 0 11 11 11 11 11
11 11 11 11 12 15 2 0 0 0 1 14 16 13 11 11 11 11
11 11 11 11 11 0 0 0 0 0 0 0 0 11 11 11 11 11
11 11 11 11 11 0 0 0 0 0 0 0 0 11 11 11 11 11
11 11 11 11 11 0 0 1 14 15 2 0 0 11 11 11 11 11
11 11 11 11 11 0 0 0 0 0 0 0 0 11 11 11 11 11
11 11 11 11 11 0 0 0 0 0 0 0 0 11 11 11 11 11
11 11 11 11 12 15 2 0 0 0 0 1 14 13 11 11 11 11
11 11 11 11 11 0 0 0 0 0 0 0 0 11 11 11 11 11
11 11 11 11 11 0 0 0 0 0 0 0 0 11 11 11 11 11
11 11 11 11 11 0 1 16 2 1 16 2 0 11 11 11 11 11
11 11 11 11 11 0 0 0 0 0 0 0 0 11 11 11 11 11
11 11 11 11 11 0 0 0 0 0 0 0 0 11 11 11 11 11
11 11 11 11 11 0 0 1 14 15 2 0 0 11 11 11 11 11
11 11 11 11 11 0 0 0 0 0 0 0 0 11 11 11 11 11
11 11 11 11 11 0 0 0 0 0 0 0 0 11 11 11 11 11
11 11 11 11 12 15 2 0 0 1 14 15 2 11 11 11 11 11
11 11 11 11 11 0 0 0 0 0 0 0 0 11 11 11 11 11
11 11 11 11 11 0 0 0 0 0 0 0 0 11 11 11 11 11
11 11 11 11 12 15 2 0 0 0 0 1 14 13 11 11 11 11
11 11 11 11 11 0 0 0 0 0 0 0 0 11 11 11 11 11
11 11 11 11 11 0 0 0 0 0 0 0 0 11 11 11 11 11
11 11 11 11 12 15 2 0 0 0 1 14 16 13 11 11 11 11
11 11 11 11 11 0 0 0 0 0 0 0 0 11 11 11 11 11
11 11 11 11 11 0 0 0 0 0 0 0 0 11 11 11 11 11
11 11 11 11 11 1 14 16 15 2 0 0 0 11 11 11 11 11
11 11 11 11 11 0 0 0 0 0 1 14 16 13 11 11 11 11
11 11 11 11 11 0 0 0 0 0 0 0 0 11 11 11 11 11
11 11 11 11 11 0 0 0 0 0 0 0 0 11 11 11 11 11
11 11 11 11 11 0 0 0 1 14 15 2 0 11 11 11 11 11
11 11 11 11 11 0 0 0 0 0 0 0 0 11 11 11 11 11
11 11 11 11 11 0 0 0 0 0 0 0 0 11 11 11 11 11
11 11 11 11 11 0 1 14 16 15 2 0 0 11 11 11 11 11
11 11 11 11 11 0 0 0 0 0 0 0 0 11 11 11 11 11
11 11 11 11 12 15 2 0 0 0 0 0 0 11 11 11 11 11
11 11 11 11 11 0 0 0 0 0 1 14 16 13 11 11 11 11
11 11 11 11 11 0 0 0 0 0 0 0 0 11 11 11 11 11
11 11 11 11 12 16 15 2 0 0 0 0 0 11 11 11 11 11
11 11 11 11 11 0 0 0 0 0 1 14 16 13 11 11 11 11
11 11 11 11 11 0 0 0 0 0 0 0 0 11 11 11 11 11
11 11 11 11 11 0 0 1 16 2 0 0 0 11 11 11 11 11
11 11 11 11 12 15 2 0 0 0 0 0 0 11 11 11 11 11
11 11 11 11 11 0 0 0 0 0 0 0 0 11 11 11 11 11
11 11 11 11 11 0 0 0 0 0 0 0 0 11 11 11 11 11
11 11 11 11 11 0 1 14 16 16 15 2 0 11 11 11 11 11
11 11 11 11 11 0 0 0 0 0 0 0 0 11 11 11 11 11
11 11 11 11 11 0 0 0 0 0 0 0 0 11 11 11 11 11
11 11 11 11 11 0 0 0 0 0 0 1 14 13 11 11 11 11
11 11 11 11 11 0 0 0 0 0 0 0 0 11 11 11 11 11
11 11 11 11 11 0 0 0 0 0 0 0 0 11 11 11 11 11
11 11 11 11 11 0 0 0 1 14 15 2 0 11 11 11 11 11
11 11 11 11 11 0 0 0 0 0 0 0 0 11 11 11 11 11
11 11 11 11 12 15 2 0 0 0 0 0 0 11 11 11 11 11
11 11 11 11 11 0 0 0 0 0 0 0 0 11 11 11 11 11
11 11 11 11 11 0 0 0 0 0 0 0 0 11 11 11 11 11
11 11 11 11 11 0 1 14 15 2 0 0 0 11 11 11 11 11
11 11 11 11 11 0 0 0 0 0 0 0 0 11 11 11 11 11
11 11 11 11 11 0 0 0 0 0 0 1 14 13 11 11 11 11
11 11 11 11 11 0 0 0 0 0 0 0 0 11 11 11 11 11
11 11 11 11 11 0 0 0 0 0 0 0 0 11 11 11 11 11
11 11 11 11 11 0 0 0 0 0 0 1 14 13 11 11 11 11
11 11 11 11 11 0 0 0 0 0 0 0 0 11 11 11 11 11
11 11 11 11 11 0 0 0 0 0 0 0 0 11 11 11 11 11
11 11 11 11 11 0 0 1 14 16 15 2 0 11 11 11 11 11
11 11 11 11 11 0 0 0 0 0 0 0 0 11 11 11 11 11
11 11 11 11 11 0 0 0 0 0 0 0 0 11 11 11 11 11
0 0 0 0 0 0 0 0 0 0 0 1 14 13 11 11 11 11
0 0 0 0 0 0 0 0 0 0 0 0 0 11 11 11 11 11
0 0 99 0 0 0 0 0 0 0 0 0 0 11 11 11 11 11
11 11 11 11 11 0 0 1 10 10 2 0 0 11 11 11 11 11
750,1950-330,5430-330,11910-750,13050-750,6990
0_30,330-0_690,30-0_390,150-0_870,450-0_930,930-0_750,930-0_330,1110-0_210,990-0_330,1530-0_150,1650-0_930,1590-0_990,1770-0_930,2010-0_630,2010-0_810,2250-0_930,2250-0_450,2550-0_270,2490-0_210,2250-0_690,2610-0_870,2730-0_150,2910-0_390,2970-0_750,3150-0_210,3150-0_930,3090-0_750,3570-0_810,3570-0_870,3510-0_450,3450-0_210,3510-0_150,3450-0_270,3930-0_330,3750-0_510,3990-0_750,4050-0_870,3990-0_210,4110-0_450,4290-0_630,4410-0_150,4410-0_450,4590-0_810,4590-0_930,4470-0_750,4770-0_270,4770-0_810,5010-0_450,4950-0_210,4950-0_150,5130-0_330,5310-0_930,5310-0_870,5430-0_690,5490-0_210,5490-0_210,5670-0_510,5790-0_390,5910-0_210,5970-0_210,5910-0_150,5850-0_690,6150-0_870,6030-0_930,5910-0_390,6450-0_270,6330-0_150,6630-0_330,6750-0_930,6630-0_810,6690-0_750,6630-0_810,6510-0_810,7050-0_330,7110-0_210,6990-0_870,7290-0_450,7290-0_750,7530-0_930,7770-0_810,7890-0_570,8010-0_330,8430-0_870,8370-0_930,8550-0_810,8790-0_210,8790-0_150,8970-0_570,8970-0_870,9330-0_870,9210-0_450,9150-0_210,9210-0_270,9390-0_690,9690-0_210,9750-0_150,9870-0_390,9930-0_810,10050-0_870,10050-0_870,9990-0_150,10230-0_270,10350-0_630,10350-0_930,10470-0_390,10590-0_210,10650-0_750,10770-0_810,10950-0_210,11010-0_810,11190-0_390,11190-0_930,11430-0_270,11430-0_930,11670-0_210,11670-0_690,11850-0_870,11970-0_450,12030-0_270,11970-0_450,12270-0_150,12270-0_810,12450-0_870,12570-0_390,12510-0_210,12450-0_810,12870-0_450,12870-0_210,12930-0_150,12750-0_750,13230-0_930,13110-0_270,13350-0_570,13530-0_870,13650-0_330,13770-0_210,13650-0_810,13890-0_930,13830-0_810,14010-0_750,14070-0_930,14190-0_150,14250-0_210,14370-0_450,14430-0_870,14430-0_930,14610-0_870,14970-0_570,14790-0_210,14730-0_210,13170-0_870,11070-0_150,11190-0_870,1410-0_510,510
