1
1
5,68
26,1
30
70
11 11 11 0 0 0 0 0 0 0 0 0 0 0 0 0 0 0 0 0 0 0 0 0 0 0 0 0 0 0 0 0 0 0 0 0 0 0 0 0 0 0 0 0 0 0 0 0 0 0 0 0 0 0 0 0 0 0 0 0 0 0 0 0 0 0 0 0 0 0
11 11 11 0 0 0 0 0 0 0 0 0 0 0 0 0 0 0 0 0 0 0 0 0 0 0 0 0 0 0 0 0 0 0 0 0 0 0 0 0 0 0 0 0 0 0 0 0 0 0 0 0 0 0 0 0 0 0 0 0 0 0 0 0 0 0 0 0 0 0
11 11 11 0 0 1 10 2 0 0 0 0 1 14 16 16 16 15 2 0 0 0 0 0 0 0 0 0 0 0 0 0 0 0 0 0 0 0 0 0 0 0 0 0 0 0 0 0 0 0 0 0 0 0 0 0 0 0 0 0 0 0 0 0 0 0 0 0 0 0
11 11 11 0 0 0 11 0 0 0 0 0 0 0 0 0 0 0 0 0 0 0 0 0 0 0 0 0 0 0 0 0 0 0 0 0 0 0 0 0 0 0 0 0 0 0 0 0 0 0 0 0 0 0 0 0 0 0 0 0 0 0 0 0 0 0 0 0 0 0
17 17 17 0 0 0 18 16 15 2 0 0 0 0 0 0 0 0 0 0 0 0 0 0 0 0 0 0 0 0 0 0 0 0 0 0 0 0 0 0 0 0 0 0 0 0 0 0 0 0 0 0 0 0 0 0 0 0 0 0 0 0 0 0 0 0 0 0 0 0
0 0 0 0 0 0 0 0 0 0 0 0 0 0 0 0 0 1 16 2 0 0 0 0 0 0 0 0 0 0 0 0 0 0 0 0 0 0 0 0 0 0 0 0 0 0 0 0 1 14 16 15 2 0 0 0 0 0 0 0 0 0 0 0 0 0 0 0 99 0
0 0 0 0 0 0 0 0 0 0 0 0 0 0 0 0 0 0 0 0 0 0 0 0 0 0 0 0 0 0 0 0 0 0 0 0 0 0 0 0 0 0 0 0 0 0 0 0 0 0 0 0 0 0 0 0 0 0 1 14 16 15 2 0 0 1 10 10 10 10
0 0 0 0 0 0 0 0 0 0 0 0 0 0 0 0 0 0 0 0 0 0 0 0 0 0 0 0 0 0 0 0 0 0 0 0 0 0 0 0 0 0 0 0 0 0 0 0 0 0 0 0 0 0 0 0 0 0 0 0 0 0 0 0 0 0 11 11 11 11
0 0 0 1 16 2 0 0 0 0 0 0 0 0 0 0 0 0 0 1 16 2 0 0 0 0 0 0 0 0 0 0 0 0 0 0 0 0 0 0 0 0 0 0 0 0 0 0 0 0 0 0 0 0 0 0 0 0 0 0 0 0 0 0 0 0 11 11 11 11
0 0 0 0 0 0 0 0 0 0 0 0 0 0 0 0 0 0 0 0 0 0 0 0 0 0 0 0 0 0 0 0 0 0 0 0 0 0 0 0 0 0 0 0 0 1 10 10 10 10 10 10 10 10 10 2 0 0 0 0 0 0 0 0 0 0 11 11 11 11
0 1 16 2 0 1 16 2 0 0 0 0 0 0 0 0 0 0 0 0 0 0 0 0 0 0 0 0 0 0 0 0 0 0 0 0 0 0 0 0 0 0 0 0 0 0 11 11 11 11 11 11 11 11 11 0 0 0 0 0 0 0 0 0 0 0 11 11 11 11
0 0 0 0 0 0 0 0 0 0 0 0 0 0 0 0 0 0 1 16 2 0 0 0 0 0 1 14 16 16 16 15 2 0 0 1 10 10 10 10 10 2 0 0 0 0 11 11 11 11 11 11 11 11 11 0 0 0 0 0 0 0 0 0 0 0 11 11 11 11
0 0 0 0 0 0 0 0 0 0 0 0 0 0 0 0 0 0 0 0 0 0 0 0 0 0 0 0 0 0 0 0 0 0 0 0 11 11 11 11 11 0 0 0 0 0 11 11 11 11 11 11 11 11 11 0 0 0 0 0 0 0 0 0 0 0 11 11 11 11
0 0 0 0 0 0 0 0 0 0 0 0 0 0 0 0 0 0 0 0 0 0 0 0 0 0 0 0 0 0 0 0 0 0 0 0 11 11 11 11 11 0 0 0 0 0 11 11 11 11 11 11 11 11 11 0 0 0 0 0 0 0 0 0 0 0 11 11 11 11
10 10 10 10 10 10 10 10 10 2 0 0 0 0 0 0 0 0 0 0 0 1 14 16 15 2 0 0 0 0 0 0 0 0 0 0 8 8 8 8 8 0 0 0 0 0 11 11 11 11 11 11 11 11 11 0 0 0 0 0 0 0 0 0 0 0 11 11 11 11
11 11 11 11 11 11 11 11 11 0 0 0 0 0 0 0 0 0 0 0 0 0 0 0 0 0 0 0 0 0 0 0 0 0 0 0 8 8 8 8 8 0 0 0 0 0 11 11 11 11 11 11 11 11 11 0 0 0 0 0 0 0 0 0 0 0 11 11 11 11
11 11 11 11 11 11 11 11 11 0 0 0 0 0 0 0 0 0 0 0 0 0 0 0 0 0 0 0 0 0 0 0 0 0 0 0 8 8 8 8 8 0 0 0 0 0 11 11 11 11 11 11 11 11 11 0 0 0 0 0 0 0 0 0 0 0 11 11 11 11
11 11 11 11 11 11 11 11 12 15 2 0 0 0 0 0 0 0 0 0 0 0 0 0 0 0 1 14 16 16 16 15 2 0 0 0 11 11 11 11 11 0 0 0 0 0 11 11 11 11 11 11 11 11 11 0 0 0 0 0 0 0 0 0 0 0 11 11 11 11
17 17 17 17 17 17 17 17 17 0 0 0 0 0 0 0 0 0 0 0 0 0 0 0 0 0 0 0 0 0 0 0 0 0 0 0 11 11 11 11 11 0 0 0 0 0 11 11 11 11 11 11 11 11 11 0 0 0 0 0 0 0 0 0 0 0 11 11 11 11
0 0 0 0 0 0 0 0 0 0 0 0 0 0 0 0 0 0 0 0 0 0 0 0 0 0 0 0 0 0 0 0 0 0 0 0 11 11 11 11 11 0 0 0 0 0 11 11 11 11 11 11 11 11 11 0 0 0 0 0 0 0 0 0 0 0 11 11 11 11
0 0 0 0 0 0 0 0 0 0 0 1 14 16 15 2 0 0 0 0 0 0 0 0 0 0 0 0 0 0 0 0 0 0 0 0 11 11 11 11 11 0 0 0 0 0 11 11 11 11 11 11 11 11 11 0 0 0 0 0 0 0 0 0 0 0 11 11 11 11
0 0 0 0 0 0 0 0 0 0 0 0 0 0 0 0 0 0 0 0 0 0 0 0 0 0 0 0 0 0 0 0 0 0 0 0 11 11 11 11 11 0 0 0 0 0 11 11 11 11 11 11 11 11 11 0 0 0 0 0 0 0 0 0 0 0 11 11 11 11
0 0 0 0 0 0 0 0 0 0 0 0 0 0 0 0 0 0 0 0 0 0 0 0 0 0 0 0 0 0 0 0 0 0 0 0 11 11 11 11 11 0 0 0 0 0 11 11 11 11 11 11 11 11 11 0 0 0 0 0 0 0 0 0 0 0 11 11 11 11
0 0 0 0 0 0 0 0 0 0 0 0 0 0 0 1 14 16 15 2 0 0 0 0 0 0 0 0 0 0 0 0 0 0 0 0 11 11 11 11 11 0 0 0 0 0 11 11 11 11 11 11 11 11 11 0 0 0 0 0 0 0 0 0 0 0 11 11 11 11
0 0 0 0 0 1 14 16 15 2 0 0 0 0 0 0 0 0 0 0 0 0 0 0 0 0 0 0 0 0 0 0 0 0 0 0 11 11 11 11 11 0 0 0 0 0 11 11 11 11 11 11 11 11 11 0 0 0 0 0 0 0 0 0 0 0 11 11 11 11
0 0 0 0 0 0 0 0 0 0 0 1 14 16 15 2 0 0 0 0 0 0 0 0 0 0 0 0 0 0 0 0 0 0 0 0 11 11 11 11 11 0 0 0 0 0 11 11 11 11 11 11 11 11 11 0 0 0 0 0 0 0 0 0 0 0 11 11 11 11
0 98 0 0 0 0 0 0 0 0 0 0 0 0 0 0 0 0 0 0 0 0 0 0 0 0 0 0 0 0 0 0 0 0 0 0 11 11 11 11 11 0 0 0 0 0 11 11 11 11 11 11 11 11 11 0 0 0 0 0 0 0 0 0 0 0 11 11 11 11
10 10 10 2 0 0 0 0 0 0 0 0 0 0 0 0 0 0 0 0 0 0 0 0 0 0 0 0 0 0 0 0 0 0 0 0 11 11 11 11 11 0 0 0 0 0 11 11 11 11 11 11 11 11 11 0 0 0 0 0 0 0 0 0 0 0 11 11 11 11
11 11 11 0 0 0 0 0 0 0 0 0 0 0 0 0 0 0 0 0 0 0 0 0 0 0 0 0 0 0 0 0 0 0 0 0 11 11 11 11 11 0 0 0 0 0 11 11 11 11 11 11 11 11 11 0 0 0 0 0 0 0 0 0 0 0 11 11 11 11
11 11 11 0 0 0 0 0 0 0 0 0 0 0 0 0 0 0 0 0 0 0 0 0 0 0 0 0 0 0 0 0 0 0 0 0 11 11 11 11 11 0 0 0 0 0 11 11 11 11 11 11 11 11 11 0 0 0 0 0 0 0 0 0 0 0 11 11 11 11
2310,630-930,90
0_3630,330-1_3030,390-0_2370,990-0_2250,990-0_1770,990-0_1770,630-1_1830,750-1_1710,750-0_990,90-0_870,90-1_150,330-1_390,330-1_270,570-0_270,810-0_810,1170-1_810,1290-0_450,1410
