0
0
15,0
10,48
20
50
0 0 0 0 0 0 0 0 0 0 0 0 0 0 0 0 0 0 0 0 0 0 0 0 0 0 0 0 0 0 0 0 0 0 0 0 0 0 0 0 0 0 0 0 0 0 0 0 0 0
0 0 0 0 0 0 0 0 0 0 0 0 0 0 0 0 0 0 0 0 0 0 0 0 0 0 0 0 0 0 0 0 0 0 0 0 0 0 0 0 0 0 0 0 0 0 0 0 0 0
0 0 0 0 0 0 0 0 0 0 0 0 0 0 0 0 0 0 0 0 0 0 0 0 0 0 0 0 0 0 0 0 0 0 0 0 0 0 0 0 0 0 0 0 0 0 0 0 0 0
0 0 0 0 0 0 0 0 0 0 0 0 0 0 0 0 0 0 0 0 0 0 0 0 0 0 0 0 0 0 0 0 0 0 0 0 0 0 0 0 0 0 0 0 0 0 0 0 0 0
0 0 0 0 0 0 0 0 0 0 0 0 0 0 0 0 0 0 0 0 0 0 0 0 0 0 0 0 0 0 0 0 0 0 0 0 0 0 0 0 0 0 0 0 0 0 0 0 0 0
0 0 0 0 0 0 0 0 0 0 0 0 0 0 0 0 0 0 0 0 0 0 0 0 0 0 0 0 0 0 0 0 0 0 0 0 0 0 0 0 0 0 0 0 0 0 0 0 0 0
0 0 0 0 0 0 0 0 0 0 0 0 0 0 0 0 0 0 0 0 0 0 0 0 0 0 0 0 0 0 0 0 0 0 0 0 0 0 0 0 0 0 0 0 0 0 0 0 0 0
0 0 0 0 0 0 0 0 0 0 0 0 0 0 0 0 0 0 0 0 0 0 0 0 0 0 0 0 0 0 0 0 0 0 0 0 0 0 0 0 0 0 0 0 0 0 0 0 0 0
0 0 0 0 0 0 0 0 0 0 0 0 0 0 0 0 0 0 0 0 0 0 0 0 0 0 0 0 0 0 0 0 0 0 0 0 0 0 0 0 0 0 0 0 0 0 0 0 0 0
0 0 0 0 0 0 0 0 0 0 0 0 0 0 0 0 0 0 0 0 0 0 0 0 0 0 0 0 0 0 0 0 0 0 0 0 0 0 0 0 0 0 0 0 0 0 0 0 0 0
0 0 0 0 0 0 0 0 0 0 0 0 0 0 0 0 0 0 0 0 0 0 0 0 0 0 0 0 0 0 0 0 0 0 0 0 0 0 0 0 0 0 0 0 0 0 0 0 98 0
0 0 0 0 0 0 0 0 0 0 0 0 0 0 0 0 0 0 0 0 0 0 0 0 0 0 0 0 0 0 0 0 0 0 0 0 0 0 0 0 1 10 10 10 10 10 10 10 10 10
0 0 0 0 0 0 0 0 0 0 0 0 0 0 0 0 0 0 0 0 0 0 0 0 0 0 0 0 0 0 0 0 0 0 1 10 10 2 0 0 0 11 11 11 11 11 11 11 11 11
0 0 0 0 0 0 0 0 0 1 10 10 2 0 0 0 0 0 0 0 0 0 0 0 0 0 1 10 10 10 10 10 2 0 0 11 11 0 0 0 0 11 11 11 11 11 11 11 11 11
0 0 0 0 0 0 0 0 0 0 11 11 0 0 0 0 0 0 0 0 0 1 10 10 2 0 0 11 11 11 11 11 0 0 0 11 11 0 0 0 0 11 11 11 11 11 11 11 11 11
99 0 0 0 0 0 0 0 0 0 11 11 0 0 0 0 0 0 0 0 0 0 11 11 0 0 0 11 11 11 11 11 0 0 0 11 11 0 0 0 0 11 11 11 11 11 11 11 11 11
10 10 10 2 0 1 10 10 2 0 11 11 0 0 0 0 1 10 10 2 0 0 11 11 0 0 0 11 11 11 11 11 0 0 0 11 11 0 0 0 0 11 11 11 11 11 11 11 11 11
11 11 11 0 0 0 11 11 0 0 11 11 0 0 0 0 0 11 11 0 0 0 11 11 0 0 0 11 11 11 11 11 0 0 0 11 11 0 0 0 0 11 11 11 11 11 11 11 11 11
11 11 11 0 0 0 11 11 0 0 11 11 0 0 0 0 0 11 11 0 0 0 11 11 0 0 0 11 11 11 11 11 0 0 0 11 11 0 0 0 0 11 11 11 11 11 11 11 11 11
11 11 11 0 0 0 11 11 0 0 11 11 0 0 0 0 0 11 11 0 0 0 11 11 0 0 0 11 11 11 11 11 0 0 0 11 11 0 0 0 0 11 11 11 11 11 11 11 11 11
690,750-450,930-2730,630-2670,630-2610,630-2610,570-2670,570-2730,570-2730,510-2670,510-2610,510-2550,510-2550,570-2550,630-1710,750-1830,750-2190,690-1110,930-1410,810-150,930
null
