2
2
16,2
4,49
30
70
0 0 0 0 0 0 0 0 0 0 0 0 0 0 0 0 0 0 0 0 0 0 0 0 0 0 0 0 0 0 0 0 0 0 0 0 0 0 0 0 0 0 0 0 0 0 0 0 0 0 0 0 0 0 0 0 0 0 0 0 0 0 0 0 0 0 0 0 0 0
0 0 0 0 0 0 0 0 0 0 0 0 0 0 0 0 0 0 0 0 0 0 0 0 0 0 0 0 0 0 0 0 0 0 0 0 0 0 0 0 0 0 0 0 0 0 0 0 0 0 0 0 0 0 0 0 0 0 0 0 0 0 0 0 0 0 0 0 0 0
0 0 0 0 0 0 0 0 0 0 0 0 0 0 0 0 0 0 0 0 0 0 0 0 0 0 0 0 0 0 0 0 0 0 0 0 0 0 1 16 2 0 0 0 0 0 0 0 0 0 0 0 0 0 0 0 0 0 0 0 0 0 0 0 0 0 0 0 0 0
0 0 0 0 0 0 0 0 0 0 0 0 0 0 0 0 0 0 0 0 0 0 0 0 0 0 0 0 0 0 0 0 0 0 0 0 0 0 0 0 0 1 16 2 0 0 0 0 0 0 0 0 0 0 0 0 0 0 0 0 0 0 0 6 3 0 0 0 0 0
0 0 0 0 0 0 0 0 0 0 0 0 0 0 0 0 0 0 0 0 0 0 0 0 0 0 0 0 1 16 2 0 0 1 16 2 0 0 0 0 0 0 0 0 0 0 0 0 0 98 0 0 0 0 0 0 0 0 0 0 0 1 10 10 10 2 0 0 1 10
0 0 0 0 0 0 0 0 0 0 0 0 0 0 0 0 0 0 0 0 1 14 16 15 2 0 0 0 0 0 0 0 0 0 0 0 0 0 0 0 0 0 0 0 0 0 0 1 14 16 15 2 1 16 2 0 0 0 0 0 0 0 11 11 11 0 0 0 0 11
0 0 0 0 0 0 0 0 0 0 0 0 0 0 0 0 0 0 0 0 0 0 0 0 0 0 0 0 0 0 0 1 16 2 0 0 1 16 2 0 0 1 10 2 0 0 0 0 0 0 0 0 0 0 0 0 0 0 0 0 0 0 11 11 11 0 0 0 0 11
0 0 0 0 0 0 0 0 0 0 0 0 0 0 0 0 0 0 0 0 0 0 0 0 0 0 0 0 0 0 0 0 0 0 0 0 0 0 0 0 0 0 0 0 0 0 0 0 0 0 0 0 0 0 0 0 0 0 0 0 1 14 13 11 12 15 2 0 0 11
0 0 0 0 0 0 0 0 0 0 0 0 0 0 0 0 0 0 1 14 16 16 16 16 16 15 2 0 1 16 2 0 0 0 0 0 0 0 0 1 16 2 0 0 0 0 0 0 0 0 0 0 1 16 2 0 0 0 0 0 0 0 11 11 11 0 0 0 0 11
0 0 0 0 0 0 0 0 0 0 0 0 0 0 0 0 0 0 0 0 0 0 0 0 0 0 0 0 0 0 0 0 0 0 1 16 2 0 0 0 0 0 0 1 16 2 0 0 0 0 0 0 0 0 0 0 0 0 0 0 0 0 11 11 11 0 0 0 0 11
0 0 0 0 0 0 0 0 0 0 0 0 0 0 0 0 0 0 0 0 0 0 0 0 0 0 0 0 0 0 0 1 16 2 0 0 0 0 0 0 0 0 0 0 0 0 0 0 0 0 0 0 0 0 0 0 0 0 5 0 0 0 11 11 12 15 2 0 0 11
0 0 0 0 0 0 0 0 0 0 0 0 1 14 16 15 2 0 0 0 0 0 0 0 0 0 0 0 0 0 0 0 0 0 0 0 0 0 0 0 0 0 0 0 0 1 16 2 0 0 0 0 0 0 0 1 10 10 10 10 10 10 13 11 11 0 0 0 0 11
0 0 0 0 0 0 0 0 0 0 0 0 0 0 0 0 0 0 0 0 0 0 0 0 0 0 0 0 0 0 0 0 0 0 0 0 0 0 0 0 0 0 0 0 0 0 0 0 0 0 0 0 0 0 0 0 11 11 11 11 11 11 11 11 11 0 0 1 14 13
0 0 0 0 0 0 0 0 0 0 0 0 0 0 0 0 0 0 0 0 0 0 0 0 0 0 0 0 0 0 0 0 0 0 0 0 0 0 0 0 0 0 0 0 0 0 0 0 0 0 0 0 0 0 0 0 11 11 11 11 11 11 11 11 11 0 0 0 0 11
0 0 0 0 0 0 0 0 0 1 16 2 0 0 0 0 0 0 0 0 0 0 0 0 0 0 0 0 0 0 0 0 0 0 0 0 0 0 0 0 0 0 0 0 0 0 0 1 14 15 2 0 0 0 0 0 11 11 11 11 11 11 11 11 11 0 0 0 0 11
0 0 0 0 0 0 0 0 0 0 0 0 0 0 0 0 0 0 0 0 0 0 0 0 0 0 0 0 0 0 0 0 0 0 0 0 0 0 0 0 0 0 0 0 0 0 0 0 0 0 0 0 0 0 0 0 11 11 11 11 11 11 11 11 11 0 0 1 14 13
0 3 99 0 0 0 5 0 0 0 0 0 0 0 0 3 6 0 3 0 0 0 0 0 0 0 0 0 0 0 0 0 0 0 0 0 0 0 0 0 0 0 0 0 0 0 0 0 0 0 0 0 6 3 0 0 11 11 11 11 11 11 11 11 11 0 0 0 0 11
10 10 10 10 10 10 10 10 2 0 0 0 1 10 10 10 10 10 10 10 10 10 2 0 0 0 0 0 0 0 0 0 0 0 0 0 0 0 0 0 0 0 0 0 0 0 0 0 0 1 10 10 10 10 10 10 13 11 11 11 11 11 11 11 11 0 0 0 0 11
11 11 11 11 11 11 11 11 0 0 0 0 0 11 11 11 11 11 11 11 11 11 0 0 0 0 0 0 0 0 0 0 0 0 0 0 0 0 0 0 0 0 0 0 0 0 0 0 0 0 11 11 11 11 11 11 11 11 11 11 11 11 11 11 12 15 2 0 0 11
11 11 11 11 11 11 11 11 0 0 0 0 0 11 11 11 11 11 11 11 11 11 0 0 0 0 4 0 0 0 0 0 0 0 0 0 0 3 0 0 0 0 0 0 0 0 4 0 0 0 11 11 11 11 11 11 11 11 11 11 11 11 11 11 11 0 0 0 0 11
11 11 11 11 11 11 11 11 0 0 0 0 0 11 11 11 11 11 11 11 11 11 0 0 0 1 10 10 10 10 2 0 1 10 2 0 1 10 2 0 1 10 2 0 1 10 10 10 10 10 13 11 11 11 11 11 11 11 11 11 11 11 0 0 0 0 0 0 0 11
11 11 11 11 11 11 11 11 0 0 0 0 0 11 11 11 11 11 11 11 11 11 0 0 0 0 11 11 11 11 0 0 0 11 0 0 0 11 0 0 0 11 0 0 0 11 11 11 11 11 11 11 11 11 11 11 11 11 11 11 11 11 0 0 0 0 0 1 14 13
11 11 11 11 11 11 11 11 0 0 0 0 0 11 11 11 11 11 11 11 11 11 0 0 0 0 11 11 11 11 0 0 0 11 0 0 0 11 0 0 0 11 0 0 0 11 11 11 11 11 11 11 11 11 11 11 0 0 0 0 0 0 0 0 0 0 0 0 0 11
11 11 11 11 11 11 11 11 0 0 0 0 0 11 11 11 11 11 11 11 11 11 0 0 0 0 11 11 11 11 0 0 0 11 0 0 0 11 0 0 0 11 0 0 0 11 11 11 11 11 11 11 11 11 11 11 0 0 0 0 0 0 0 0 0 0 0 0 0 11
11 11 11 11 11 11 11 11 0 0 0 0 0 11 11 11 11 11 11 11 11 11 0 0 0 0 11 11 11 11 0 0 0 11 0 0 0 11 0 0 0 11 0 0 0 11 11 11 11 11 11 11 11 11 11 11 0 0 0 0 0 0 0 0 0 0 1 16 2 11
11 11 11 11 11 11 11 11 0 0 0 0 0 11 11 11 11 11 11 11 11 11 0 0 0 0 11 11 11 11 0 0 0 11 0 0 0 11 0 0 0 11 0 0 0 11 11 11 11 11 11 11 11 11 11 11 0 0 0 0 0 0 0 0 0 0 0 0 0 11
11 11 11 11 11 11 11 11 0 0 0 0 0 11 11 11 11 11 11 11 11 11 0 0 0 0 11 11 11 11 0 0 0 0 0 0 0 0 0 0 0 0 0 0 0 0 0 0 0 0 0 0 0 0 0 0 0 0 0 0 0 0 1 16 2 0 0 0 0 11
11 11 11 11 11 11 11 11 0 0 0 0 0 11 11 11 11 11 11 11 11 11 0 0 0 0 11 11 11 11 0 0 0 0 0 0 0 0 0 0 0 0 0 0 0 0 0 0 0 0 0 0 0 0 0 0 0 0 0 0 0 0 0 0 0 0 0 0 0 11
11 11 11 11 11 11 11 11 0 0 0 0 0 11 11 11 11 11 11 11 11 11 0 0 0 0 11 11 11 12 15 2 0 11 0 0 0 11 0 0 0 11 0 0 0 11 11 11 11 11 11 11 11 11 11 11 0 0 1 16 2 0 0 0 0 0 0 0 0 11
11 11 11 11 11 11 11 11 0 0 0 0 0 11 11 11 11 11 11 11 11 11 0 0 0 0 11 11 11 11 0 0 0 11 0 0 0 11 0 0 0 11 0 0 0 11 11 11 11 11 11 11 11 11 11 11 0 0 0 0 0 0 0 0 0 0 0 0 0 11
1830,1650-1350,270
1_2850,1170-0_1710,1170-0_1170,990-0_930,990-0_870,630-1_2850,1650-1_3210,1650-0_1230,450-0_1470,450
