2
2
18,0
8,48
20
50
11 11 11 11 11 11 11 11 11 11 11 11 11 11 11 0 0 0 0 0 0 0 0 0 0 0 0 0 0 0 0 0 0 0 0 11 11 11 11 11 11 11 11 11 11 11 0 0 0 0
11 0 0 0 0 0 0 0 0 0 0 0 11 11 0 0 0 0 0 0 0 0 0 0 0 0 0 0 0 0 0 0 0 0 0 0 11 11 11 11 11 11 11 11 11 11 0 0 0 0
11 0 0 0 0 0 0 0 0 0 0 0 0 11 0 0 0 0 0 0 0 0 0 0 0 0 0 0 0 0 0 0 0 0 0 0 11 11 11 11 11 11 11 11 11 11 0 0 0 0
11 11 11 11 11 11 11 11 11 11 0 0 0 0 0 0 0 0 0 0 0 0 0 0 0 0 0 0 0 0 0 0 0 0 0 0 11 11 11 0 11 11 11 0 0 0 0 0 0 0
11 11 11 11 11 11 11 11 11 11 11 11 0 0 0 0 0 0 1 14 15 2 0 0 0 0 0 0 0 0 0 0 0 0 0 0 11 11 11 0 11 11 11 0 0 0 0 0 0 0
11 11 11 11 11 11 11 11 11 11 11 11 11 0 0 0 0 0 0 0 0 0 0 0 0 0 0 0 0 0 0 0 0 0 0 0 0 11 0 0 0 11 11 0 0 4 0 0 0 0
11 11 11 11 11 11 11 11 11 11 11 11 11 11 0 0 0 0 0 0 0 0 1 14 15 2 0 0 0 0 0 0 0 0 0 0 0 11 0 0 0 0 0 0 1 10 2 0 0 0
11 11 0 0 0 0 11 11 0 11 11 0 11 11 0 0 0 0 0 0 0 0 0 0 0 0 0 0 0 0 0 0 0 0 0 0 0 11 0 0 0 0 0 0 0 11 0 0 0 0
11 11 0 0 0 0 0 11 0 11 11 0 0 11 0 0 0 0 0 0 0 0 0 0 0 0 0 0 8 8 0 0 0 0 0 0 0 0 0 0 0 0 0 0 0 11 0 0 98 0
11 11 0 0 0 0 0 0 0 11 0 0 0 11 0 0 0 0 0 0 0 0 0 0 0 0 0 1 14 15 2 0 0 0 0 0 0 0 0 0 1 10 10 10 10 11 0 1 10 2
11 11 0 0 0 0 0 0 0 0 0 0 0 0 0 0 0 0 0 0 0 0 0 0 0 0 0 0 0 0 0 0 0 0 0 0 0 0 5 1 10 13 11 11 11 11 0 0 0 0
11 0 0 0 0 0 0 0 0 0 0 0 0 0 0 0 0 0 0 0 0 0 0 0 8 8 8 0 0 0 0 0 0 0 0 0 1 10 10 10 13 11 11 11 11 11 0 0 0 0
11 0 0 0 0 0 0 0 0 3 0 0 0 0 0 0 0 0 0 0 0 0 0 1 14 16 15 2 0 0 0 0 1 14 15 2 0 11 11 11 11 11 11 11 11 11 0 0 0 0
11 0 0 0 0 0 0 0 1 10 2 0 0 0 0 0 1 10 2 0 0 0 0 0 0 0 0 0 0 0 0 0 0 0 0 0 0 11 11 11 0 11 11 11 0 0 0 0 0 0
11 0 0 0 0 0 0 0 0 11 0 0 1 10 2 0 0 11 0 0 1 10 2 0 0 0 0 0 1 14 15 2 0 0 0 0 0 11 11 0 0 11 11 11 0 0 0 0 0 0
11 0 0 0 8 8 7 7 0 11 0 0 0 11 0 0 0 11 0 0 0 11 0 0 0 0 0 0 0 0 0 0 0 0 0 0 0 11 11 0 0 11 0 11 0 0 0 0 0 0
0 0 0 1 10 10 10 10 10 13 0 0 0 11 0 0 0 11 0 0 0 11 0 0 0 0 0 0 0 0 0 0 0 0 0 0 0 11 0 0 0 0 0 0 0 0 0 0 0 0
0 0 1 10 13 11 11 11 11 11 0 0 0 11 0 0 0 11 0 0 0 11 0 0 0 0 0 0 0 0 0 0 0 0 0 0 0 11 0 0 0 0 0 0 0 0 0 0 0 0
99 0 0 11 11 11 11 11 11 11 0 0 0 11 0 0 0 11 0 0 0 11 0 0 0 0 0 0 0 0 0 0 0 0 0 0 0 11 0 0 0 0 0 0 0 0 0 0 0 0
10 10 10 13 11 11 11 11 11 11 0 0 0 11 0 0 0 11 0 0 0 11 0 0 0 0 0 0 0 0 0 0 0 0 0 0 0 0 0 0 0 0 0 0 0 0 0 0 0 0
2070,690
1_2670,510-0_1590,690-0_390,930
